0,300,160,4,0,100,50,50,0,1
0,400,160,4,0,100,50,50,0,1
0,500,160,4,0,100,50,50,0,1
0,600,160,4,0,100,50,50,0,1
0,700,160,4,0,100,50,50,0,1
0,800,160,4,0,100,50,50,0,1
0,900,160,4,0,100,50,50,0,1
